{
    "AED": "ae",
    "ANG": "cw",
    "AUD": "au",
    "BHD": "bh",
    "BND": "bn",
    "CHF": "ch",
    "CNY": "cn",
    "DKK": "dk",
    "EUR": "eu",
    "FJD": "fj",
    "FKP": "fk",
    "GBP": "gb",
    "GGP": "gg",
    "GIP": "gi",
    "HKD": "hk",
    "IMP": "im",
    "JEP": "je",
    "JPY": "jp",
    "KWD": "kw",
    "LSL": "ls",
    "MVR": "mv",
    "MWK": "mw",
    "NAD": "na",
    "NPR": "np",
    "NZD": "nz",
    "OMR": "om",
    "PGK": "pg",
    "PHP": "ph",
    "QAR": "qa",
    "SAR": "sa",
    "SBD": "sb",
    "SCR": "sc",
    "SGD": "sg",
    "SHP": "sh",
    "SLL": "sl",
    "SZL": "sz",
    "THB": "th",
    "TRY": "tr",
    "TWD": "tw",
    "USD": "us",
    "VUV": "vu",
    "WST": "ws",
    "XAG": "un",
    "XAU": "un",
    "XCD": "ag",
    "XDR": "un",
    "XPF": "pf",
    "ZAR": "za"
}